
15
8
 S  1  S  1  1  1  1  1  1  1  1  1  S  1  S
 S  .  S  .  S  .  S  .  S  .  S  .  S  .  S
 S  1  3  1  3  1  3  1  3  1  3  1  3  1  S
 S  .  1  .  1  .  1  .  1  .  1  .  1  .  S
 S  U  3  U  3  U  3  U  3  U  3  U  3  U  S
 S  .  S  .  S  .  S  .  S  .  S  .  S  .  S
 1  1  2  1  2  U  2  U  2  U  2  1  2  1  1
 1  1  1  1  1  1  1  1  1  1  1  1  1  1  1
