15
8
 1  1  1  1  S  1  1  1  1  1  S  1  1  1  1
 U  1  1  1  1  1  U  U  U  1  1  1  1  1  U
 U  S  S  1  1  1  .  1  .  1  1  1  S  S  U
 1  1  1  1  S  1  .  1  .  1  S  1  1  1  1
 1  1  1  1  S  1  .  1  .  1  S  1  1  1  1
 S  .  .  1  S  1  1  1  1  1  S  1  .  .  S
 S  .  .  1  1  U  U  U  U  U  1  1  .  .  S
 1  1  1  1  1  1  1  1  1  1  1  1  1  1  1
