15
8
 U  S  U  S  U  S  U  S  U  S  U  S  U  S  U
 1  2  2  2  2  2  2  2  2  2  2  2  2  2  1
 1  2  S  S  U  U  U  U  U  U  U  S  S  2  1
 1  2  S  5  5  5  5  5  5  5  5  5  S  2  1
 1  2  S  5  5  5  5  5  5  5  5  5  S  2  1
 1  2  S  S  U  U  U  U  U  U  U  S  S  2  1
 1  2  2  2  2  2  2  2  2  2  2  2  2  2  1
 1  1  1  1  1  1  1  1  1  1  1  1  1  1  1
