15
8
 3  1  1  S  S  1  1  1  1  1  S  S  1  1  3
 3  1  1  1  1  1  S  S  S  1  1  1  1  1  3
 3  1  1  S  S  5  5  5  5  5  S  S  1  1  3
 3  U  U  S  S  5  5  5  5  5  S  S  U  U  3
 3  U  U  S  S  5  5  5  5  5  S  S  U  U  3
 S  S  3  S  S  S  S  S  S  S  S  S  3  S  S
 S  S  5  5  5  5  5  5  5  5  5  5  5  S  S
 S  5  5  5  5  5  U  U  U  5  5  5  5  5  S
